#G##############
#              #
#### ######### #
#    ###       #
# ## ### ## ####
# ## ###  # ####
# #########    #
#      # ##### #
# ###### ##### #
# #   #      # #
### # ###### # #
# # #        # #
# # ######## # #
# ########## # #
#  S   #       #
################
